O-----T----O------E--------
TE----O----------E-----B---
E-E-------T-----E----------
E--E----O------E-----------
T---E-O-------E--E----B----
E----E---T---E-------------
T-O---E-----E-----T--------
E-------O---E--O-----------
E--O----E-E----O--T---B----
E---T----E-O---------------
